the: taq aki
fnc: shq dvj nhp ule
eub: pxs you apo
fde: out
bsp: shq dvj nhp
inu: nvm qbu pwf
grs: iom
ygp: irk mwz jou jbq jnh pgo kxa uya hqf ykx tlh ewb
rlk: qcl
byn: vxi wdb
hfl: kec bti ulu
vni: bbm
hux: yqt
xca: hww hzg auz
rdq: plm
sbb: zgs
qlb: nvm pez pwf
yil: dry roo
zzh: hoz hvb
doc: rlk cvo mwo
gma: xor yxy tbq odi
pkq: nco kqp grs
yqd: qjy jdu imp xlc
nbn: fft hpp lcc jre
xkq: nwz lie
zix: ktb nsq
iic: out
jou: wev hmw ijf fyz
yon: efj eub nqq
von: jre fft
otl: ekk
dpy: oqa xfn
ggf: udo
auz: ojm
uvi: yaa tye
xlm: jxv hsb hwv vig
ceo: out
gmz: ysa
aki: psw xlm zzd qfz
ayo: ljt dsd ods
kfy: vvf
gmx: xor bbm tbq
lgg: bqi cjt zmb mmr
rik: lgg zfx zxh
mwz: oan uxk
gcl: tbq xor
jdu: tph jhx cvv ohv
dgc: nby yfj
tpp: flk jse kqi ltl nbr
eas: zto zru
vzg: vch qxn
vyg: rjf cui cwf
not: rgp dow
pez: hot
rrs: xlm zzd vkg psw
lyp: ysa szs cnt
zhz: srr kjo
hqz: out
acd: aan
jta: bbm tbq yxy
jyj: apo you
fky: cgh
ovt: jyr sbb lgs pyu
ujd: dub
afe: cca lgk
qov: nqq efj kpf
mlv: pyu ase
egj: grs kqp nco
dry: hoz icp qxh
nrs: wnu xlc imp jdu
lrb: tsr
awh: uxk oan yek
aik: ddr dlu vzh pvm
vgk: sbb lgs jyr
bql: gxf wmh
vya: hvo jee yzt
ods: cca oru
bqi: hhw upy tsk eeb kly yrw kjz bql qiq inu bob tbe otl eas fog
yaa: pxs apo you
wev: cgr swl ajb
jhx: out
yql: osp
wdb: rik
uld: mmr zmb cjt bqi
cwx: krg
ozg: lgg zxh zfx
irw: auz yil
tqq: bse duk ihh
tem: qnr zbg
hqf: vgk now ovt
mwo: zja yay
nxp: xfn oqa
msx: zut twi ipy fnd
qqs: mmr cjt
hpp: uld zqb
cws: plm vvf nap dtt
yfj: out
cjd: aik lva hua
ytc: lva aik
uuj: gcl
lpr: out
dac: wxe kns onr
bse: rlk
ffh: the qir
jmj: yaa tye
aiq: oru euo qrc cca
mrk: cnt
hva: jke
onr: hqq
hro: czj jta zsg
hbf: wdb vxi
ash: qxh
wmg: ybp dub cki
uya: sse mii gsj aay
xjp: hoz qxh hvb
dec: eub efj kpf nqq
bob: esf zhz zbg
cgh: pxs you
ibt: wns nhy pdw acw
cgr: odi yxy
cfr: hwz pgb dow rgp
dmn: zsg czj
cjj: itm hux
vig: hoz icp hvb
wpr: zro fss dmn hro
nhy: vib ysb utf jqz
icp: oou bvy xce wal hap mml dpy ufo dfy nek xfk egj tpp nth eyn icl qcz bsp fnc pkq nxp
tfm: cjt bqi
bqf: nwz lie inr
vkg: hsb
kec: yxx qqc kqa ryp
jse: vya ypf hva nct lkq
szs: zgn
ljt: lgk cca qrc
you: mdr yoa iwp ijc cjd
mmr: eeb kly upy bhj hhw tsk kjz bql yrw inu fek qiq tem fog otl ffh
yic: acd dhw ajh
tgc: hhq
kns: pxs
cki: gil voe ctf wgb
qcl: out
zfb: twx kpl tdr
hvo: qrc oru lgk
pdw: jqz ysb mia
wns: ysb utf vib mia
ocv: cca qrc lgk euo oru
iqu: waf dac uwo uvi
esf: wij srr kjo
icg: egf xcs bfv nja
roo: hoz icp hvb
qxn: kia
fss: czj
odi: qtw iuo ghx ebr pnj not pot ehh zix lyp hbf cfr zca gmz mrk uiv vea von ldm byn nbn
kjo: ltf kkr
dlu: nja xcs
vvb: cca
qfz: jxv
wdr: dac jmj uwo
qjy: cvv
kly: zto
peu: out
yek: luy iih mei
qxh: xce bsp tpp eyn nth ufo oou
pln: obi pfu
bip: wdb vxi ist
rno: imo fhx
sls: pyd ztw qxn
iyp: mpn wef dxi
dtt: ido alv sce peu
qud: doc ihh duk bse
wgb: euo oru cca qrc
kqi: vya hva lkq
qbu: irw xca
ybp: ctf wgb voe
mxm: bqi
zto: nzo ash gom
ums: qrc cca oru lgk
eax: fnd ipy
vxi: vfg rik
mii: fgi eax rxs
dzs: bse duk ihh
fhf: apo you
yxy: tys pot von gmz cfr
iuo: wjp
lfj: lgk euo qrc
adg: hua lva
uco: kec ulu bti
oru: jbn dzk qbg yap vyg cfw dju lrb ofr yic vhw xgh
agf: dec drd
dvj: ujd rsh
now: sbb jyr pyu
hli: uul cjj omy
tve: yxy xor
osp: arf btr xjp
lnv: odi xor bbm tbq
twx: tfm xtt
xgh: iqu wdr bxi
hhv: jdu wnu xlc
aan: rhm cgh
hzg: rol
eeb: zto bcj
ajs: jou irk kxa awh ibc ewb tlh uya
acw: ysb jqz
zbx: xts
efj: pxs you apo
ewb: hmw wev fyz
mml: jse kqi nbr ltl
mdd: nsq
vuc: hqz jbd
nbr: hva vya lkq
aay: msx fgi ewy eax
ypf: hvo yzt
cfw: agf
fyz: cgr swl gcl
nzo: hoz
ltf: btr arf nwy
dxi: qud dzs tqq unb
hcx: bti kec
tod: cjt bqi
bbm: mdd gmz iuo cfr qtw hbf not tys
kvd: hyl qqs nab rig
bti: lex ryp yxx qqc kqa
zut: pff gmx lnv
ykx: ijf wev uuj
xwt: apo you
nco: ayo iom aar
qnr: yql kjo
jcm: cgh djk rhm
ton: yfj
cwf: qov drd tks yon dec
oqa: uco hfl
kzb: rsh wmg
apo: adg ijc vzg qea sls mdr bhg pom kmi llk cwx iyp cjd
mhf: tve pto rxe
lex: qrc oru euo
krg: lie
tbq: mdd iuo not pnj ebr pot lyp zix ehh zca hbf cfr mrk von vea tys nbn byn
djk: apo you
hhw: ekk tqn bzb
fti: ysb
hsb: qxh
kpf: apo
luy: jco dmg
qiq: sai wmh ldl gxf
ajh: olo fky jcm xpf
pnj: cnt szs
wxe: you apo
fnd: dsj gmx pff
egf: wdi udr
pmo: xtr ocv
wjp: qqs rig nab hyl
btr: icp hvb
mdr: aik lva
jco: tve pto
eyn: wll yvx vow
wdi: nby yfj ceo
udr: ceo yfj
jnh: vgk now mlv
llk: bqf
flk: nct lkq vya hva
xts: wdo
pgo: hro fss elm
wdo: dtb
dfy: kqp grs
frs: arm boq
yap: iqu wdr bxi vkn
voe: qrc cca euo lgk
pgb: mkb mxm ixd ruj
ase: zgs uow vni
imp: lpr tph jhx cvv
ryp: lgk qrc
kqa: lgk euo oru cca qrc
tye: pxs
jre: uld toc
zzd: vig hwv
tks: efj eub nqq
jxv: hoz
zro: jta
rol: icp hvb qxh
qir: mpr taq aki rrs
rgp: mxm yhw
ehh: ttx
fek: ldl orh wmh sai
duk: cvo zhh rlk
cvv: out
szj: qop pmo onw dqh syt
hua: ddr icg pvm dlu
lgk: dzk vhw jbn bjx
idw: onw dqh syt pmo
gsj: rxs eax ewy fgi
elm: gma
xfk: wll yvx egz
irk: sse
xtt: zmb
ldm: rgp wyq pgb dow
jbd: out
vro: qrc cca oru euo
shq: ujd
jke: qrc cca oru lgk euo
hoz: bsp qcz fnc nxp pkq icl tpp egj xfk nek ufo xce wal hap mml bvy
jqz: yqd nrs
zgs: yxy bbm odi
xcs: wdi
fft: xfg uld
aqf: cke wjh
srr: kkr ltf osp
gue: wjh tgc pln
nby: out
fgi: zut twi
zgn: mmr zmb cjt
ido: out
nth: szj idw
byx: tdi rjp
dtb: pxs hqq
rsh: dub
ldl: gio bmw dvu
yxx: lgk
zsg: yxy tbq bbm odi
ysa: rrz tod zgn
iih: dmg
yvx: ums afe lfj aiq vro
qac: qop pmo onw syt dqh
ofr: cui rjf agf
cnt: rrz
pnn: uxk byi yek oan
iom: dsd ljt ods
nct: hvo jke yzt
ufo: oqa xfn uyo
wjh: obi pfu
ojm: icp qxh hvb
fhx: boq iic
nap: alv fde sce
ipy: dsj gmx lnv
hhg: pnn irk mwz jbq jnh ibc kxa awh uya hqf ykx tlh
jbq: now vgk mlv
qrc: hli vyg yap pjp qbg yic tmv xgh vhw snw dju lrb ofr
hqq: iyp iwp cwx mdr sls ibt vzg fbo xbq
svx: apo you hqq
uxk: vvq luy mei iih
iwp: pdw nhy fti wns
wrc: mhf
dsj: yxy tbq xor bbm
nsq: ggf kpl
lva: ddr dlu vzh icg pvm
nek: ule nhp kzb
zqb: zmb bqi cjt
ctf: qrc euo lgk oru
gle: hqq pxs
kpl: tfm udo xtt
syt: ocv
kmi: pyd vch
psw: vig dpb hwv
nwy: hvb qxh icp
tlh: zro fss hro
wnf: vvf dtt
udo: mmr zmb bqi cjt
tbe: gxf ldl sai
ruj: bqi
twi: lnv pff dsj
ysb: yqd nrs hhv
ndx: ami
ewy: fnd
ibc: mii aay
dqh: xtr
alv: out
xce: qac
qwl: hoz
xtr: euo lgk oru cca qrc
rhm: hqq you
cvo: yay jbd zja qcl
jbn: aqf
ghx: kvd wjp ttx
orh: gio bmw zzh dvu qxl
tqn: rrs
bhj: pwf nvm qbu
itm: xwt vys yqt
yhw: mmr
czj: odi yxy xor bbm
jyr: vni uow zgs
jfw: hqq you
vvq: dmg mhf
tph: out
euo: zbx snw dzk vyg
mei: mhf jco dmg
zmb: tem otl tbe bob qiq bql kjz qlb yrw upy bhj hhw
tsr: xpf fky jcm
nqq: hqq apo
ijf: swl ajb
rig: bqi
bcj: ash rii
wll: lfj
dzk: uul omy
nja: ton wdi dgc
dsd: qrc cca oru euo lgk
qea: wef dxi vdc
zja: out
jee: qrc cca oru euo
dow: ixd mxm ruj mkb
uow: xor bbm tbq yxy
uul: itm
wmh: qxl dvu zzh bmw
tdi: ndx frs imo
bzb: taq aki rrs
oan: luy wrc iih
mkb: zmb mmr
swl: bbm xor odi
zca: nsq
taq: xlm zzd
omy: itm
kqp: ayo
kji: jou pnn ewb tlh wpr pgo mwz irk ykx hqf uya kxa awh
yqt: pxs you hqq
kjz: gxf ldl sai wmh
uwo: onr kns wxe
nhp: ujd
pyd: kia byx
upy: zto bcj
obi: fhf gle kzv jyj
ltl: ypf
dpb: qxh hoz
pff: bbm tbq yxy
bfv: sza udr dgc wdi
arf: hoz qxh
svr: hhg ygp zdb kji ajs
vzh: tkr
ktb: twx kpl tdr
ulu: yxx kqa qqc
kkr: nwy xjp
pfu: jyj fhf jfw
xfn: uco
oou: idw
gom: hoz hvb
vow: ums aiq
ohv: out
ttx: qqs rig xys
fbo: pyd ztw qxn vch
cui: dec qov drd tks
yoa: xkq
nab: cjt zmb
mpn: tqq
inr: wnf rdq
drd: efj eub
fog: zhz zbg qnr
cjt: qlb yrw bql upy bhj tsk kly ffh otl tem eas qiq fek inu bob tbe
ixd: bqi cjt mmr
arm: out
uiq: tdi rjp
sce: out
wal: qac idw szj
vfg: zxh lgg
olo: djk svx cgh rhm
waf: kns tye
dhw: xpf fky
ist: vfg ozg
bvy: kqi flk
gxf: bmw
hww: ojm dry qwl roo
vys: you
imo: ami boq ftg iic
vhw: rjf cui
hwv: qxh icp
xor: ghx qtw ebr pnj not bip ehh zix lyp uiv mrk cfr vea von nbn tys byn
qqc: oru euo lgk cca
vea: kvd
zbg: yql kjo
zhh: hqz
kzv: pxs you hqq
lcc: uld xfg toc
rii: qxh hoz icp
plm: sce peu alv
hmw: gcl swl cgr
rxs: ipy twi
kxa: itj
wyq: ixd
lgs: vni uow
rrz: zmb
dmg: tve rxe
tkr: dgc sza ton
pom: bqf krg
uyo: hfl hcx uco
ami: out
hap: szj idw
vvf: fde ido alv
xys: mmr cjt bqi
qbg: wux gue
mpr: psw qfz xlm vkg
qtw: ist wdb vxi
zru: gom ash
yay: out
sse: eax ewy msx rxs
hhq: gle
pjp: agf
wef: tqq unb dzs
wnu: ohv jhx tph
hvb: icl dpy nek xfk dfy
ijc: aik hua
nwz: rdq kfy cws
pyu: vni
unb: ihh bse
toc: cjt mmr
ymz: hux vuf wdo itm
boq: out
tsk: qir
wux: tgc pln cke wjh
uhi: cki ybp
xbq: nhy
ctt: ryh hww
egz: afe vro
gil: qrc cca oru euo
ddr: tkr nja bfv xcs
vch: kia uiq
rjf: dec qov
ekk: aki mpr rrs
pxs: bhg pom llk yoa ibt ytc iwp bkx ijc xbq sls qea mdr vzg
aar: dsd ods
itj: lgs ase
yzt: qrc euo oru
ryh: dry
bjx: ajh
kia: tdi rno rjp
ule: uhi
mia: nrs yqd
ebr: hwz wyq
pot: rgp hwz dow pgb
zxh: cjt
bxi: uvi
zdb: irk jbq jnh pgo wpr kxa uya tlh ewb ykx
cke: pfu obi
utf: yqd
bkx: qxn vch pyd ztw
ztw: uiq kia
bhg: dxi wef
vib: yqd
hyl: bqi cjt zmb mmr
xpf: djk svx cgh rhm
xlc: tph cvv ohv
pwf: xca irw ctt
vuf: xwt
tmv: aqf gue wux
rjp: imo fhx ndx
ihh: zhh cvo mwo vuc
byi: iih wrc luy vvq
yrw: qir tqn ekk
zfx: mmr
lkq: jee jke yzt
sai: gio dvu zzh bmw
uiv: lcc
hwz: mkb yhw ixd
rxe: xor yxy tbq odi
snw: xts ymz cjj omy uul
ajb: tbq bbm
icl: kqp
bmw: qxh hoz icp
qop: vvb xtr
pto: bbm xor odi
pvm: egf xcs
xfg: mmr zmb cjt
cca: yic tmv snw xgh lrb dju bjx ofr hli yap cfw jbn dzk
gio: hoz qxh
tys: zfb ktb
sza: ceo
dub: wgb voe
tdr: udo
qcz: vow wll egz
hot: hzg hww ryh yil
onw: vvb xtr ocv
dju: vkn
wij: osp
vdc: qud dzs unb
nvm: xca irw ctt hot
vkn: uwo dac jmj
ftg: out
lie: cws kfy rdq
qxl: icp
dvu: icp qxh hvb